11111111111111111
1M101010000000011
10000000001111011
10101011111000001
11111110000011111
11110000111111111
11100000000000001
11100111101000101
10000000101000101
10011100101111111
10010110100000001
10110011100010001
10111000101110001
10100001100010001
101011001000100KA
10001110100010001
11111111111111111